+---------------------------+    +---+
| Hallway                            |
|                                    |
|------  -------------  -------------|
|               |           |        |
|               |                    |
|                           |        |
| Living Room   | Kitchen   | Study  |
+------------------------------------+
