
[ Yard                               {
|                                    /
/-----==-==~==-=~~~~--=~=~--+    +~~-}
{ Hallway                            \
{                                    ]
]-=-=-+  +~~=~=~--===+  +=-~~-~=--=~=|
!               |           +        (
{               +                    ]
|                           +        /
\ Living Room   + Kitchen   \ Study  !
(--~-~~--~-~-=~-==~~~=~~=-==~~=---==-{
